|--------------|--------------|--------------|
| •            |      •       |           •  |
|              |              |              |
| 1    2    3  | c    d    u  | ,   ENT   .  |
|              |              |              |
| 4    5    6  | f    l    w  | ←    ↑    →  |
|  <    >    ' |  j    k    x |  (    )    - |
| 7    8    9  | g    m    y  |ESC   ↓    "  |
|--------------|--------------|--------------|
| •            |      •       |           •  |
|              |              |              |
| •            | •            |           •  |
|              |              |              |
| 0   CPY  PST | b   nt   ct  | !    ?    ;  |
|  F1   F2   F3|       ce     |  F7   F8   F9|
|UDO  CUT  RDO |ac   ch   co  | #    $    :  |
|--------------|--------------|--------------|
| •            |      •       |           •  |
|              |              |              |
|      •       |      •       |      •       |
|              |              |              |
| /    @    \  |nd    p    ed |HOM  PUP  END |
|  F4   F5   F6|              |  F10  F11 F12|
| {    }    _  |ge   de       |INS  PDN  TAB |
|--------------|--------------|--------------|
| •            |      •       |           •  |
|              |              |              |
|           •  |           •  | •            |
|              |              |              |
| *    +    =  |nt   ou    v  | `    &    ~  |
|              |              |              |
| [    ]    %  |lo    q    z  |CPS   |    ^  |
|--------------|--------------|--------------|

No index finger button:
|--------------|--------------|--------------|
|              |              |              |
|              |              |              |
| •            |      •       |           •  |
|              |              |              |
|in   ti   ri  |en   te   er  |on  to    or  |
|  ing  it     |  and  the  ex|           TAB|   
|as   ic   is  |ea   he   es  |    ion   us  |
|--------------|--------------|--------------|
|              |              |              |
|              |              |              |
|              |              |              |
|       et     |            ro|      se      | 
|an   at   ar  | ha   th   nt |     st       |
|              |              |              |
| •            |      •       |           •  |
|--------------|--------------|--------------|
 DEL=Shift+Backspace

 Not obvious MCCs:
 ant=ano
 as=ac
 but=ba
 de=dra
 le=les
 me=mer
 ne=nea
 ra=rae
 re=reh
 se=set


---------------------------
Font size: 18
