|--------------|--------------|--------------|
| •            |      •       |           •  |
|              |              |              |
| 1    2    3  | c    d    u  | ,   ENT   .  |
|              |              |              |
| 4    5    6  | f    l    w  | ←    ↑    →  |
|  <    >    ' |  j    k    x |  (    )    - |
| 7    8    9  | g    m    y  |ESC   ↓    "  |
|--------------|--------------|--------------|
| •            |      •       |           •  |
|              |              |              |
| •            | •            |           •  |
|              |              |              |
| 0   CPY  PST | b    nt      | !    ?    ;  |
|  F1   F2   F3|              |  F7   F8   F9|
|UDO  CUT  RDO |      ch   co | #    $    :  |
|--------------|--------------|--------------|
| •            |      •       |           •  |
|              |              |              |
|      •       |      •       |      •       |
|              |              |              |
| /    @    \  | nd   p    ed |HOM  PUP  END |
|  F4   F5   F6|              |  F10  F11 F12|
| {    }    _  |      de      |INS  PDN  TAB |
|--------------|--------------|--------------|
| •            |      •       |           •  |
|              |              |              |
|           •  |           •  | •            |
|              |              |              |
| *    +    =  |  nt  ou   v  | `    &    ~  |
|              |              |              |
| [    ]    %  |      q    z  |CPS   |    ^  |
|--------------|--------------|--------------|

No index finger button:
|--------------|--------------|--------------|
|              |              |              |
|              |              |              |
| •            |      •       |           •  |
|              |              |              |
| in   ti   ri | en   te   er | on  to   or  |
|  ing  it     |  and  the  ex|              |   
| as        is | ea   he   es |     ion      |
|--------------|--------------|--------------|
|              |              |              |
|              |              |              |
|              |              |              |
|       et     |            ro|       se     | 
| an   at   ar | ha   th      |      st      |
|              |              |              |
| •            |      •       |           •  |
|--------------|--------------|--------------|
 DEL=Shift+Backspace

 Not obvious MCCs:
 ant=ano
 as=ac
 but=ba
 de=dra
 le=les
 me=mer
 ne=nea
 ra=rae
 re=reh
 se=set


---------------------------
Font size: 18
