|---------------|---------------|---------------|
|  •            |       •       |            •  |
|               |               |               |
|  1    2    3  |  c    d    u  |  ,   ENT   .  |
|               |               |               |
|  4    5    6  |  f    l    w  |  ←    ↑    →  |
|   <    >    ' |   j         x |   (    )    - |
|  7    8    9  |  g    m    y  | ESC   ↓    "  |
|---------------|---------------|---------------|
|  •            |       •       |            •  |
|               |               |               |
|  •            |  •            |            •  |
|               |               |               |
|  0   CPY  PST | co            |  !    ?    ;  |
|   F1   F2   F3|               |   F7   F8   F9|
| UDO  CUT  RDO |               |  #    $    :  |
|---------------|---------------|---------------|
|  •            |       •       |            •  |
|               |               |               |
|       •       |       •       |       •       |
|               |               |               |
|  /    @    \  |           ed  | HOM  PUP  END |
|   F4   F5   F6|               |   F10  F11 F12|
|  {    }    _  |      de       | INS  PDN  TAB |
|---------------|---------------|---------------|
|  •            |       •       |            •  |
|               |               |               |
|            •  |            •  |  •            |
|               |               |               |
|  *    +    =  |       x    v  |  `    &    ~  |
|               |               |               |
|  [    ]    %  |       q    z  | CPS   |    ^  |
|---------------|---------------|---------------|
|  -    -    -  |  -    -    -  |  -    -    -  |
|               |               |               |
|  •            |       •       |            •  |
|               |               |               |
| in   ti       | en   te   er  | on   to   or  |
|   ing  it     |   and  the  ex|               |   
|  k    v       |  p   he   es  | le   ion   b  |
|---------------|---------------|---------------|

 DEL=Shift+Backspace
 TAB=rs
 Not obvious MCCs:
 re=reh
 ro=roh
 se=set

 
---------------------------
Font size: 18

24 MCCs are shown here.