                |---------------|
   BackspIce    |BCKSP  I  SPACE|
    layout      |               |   al = al
                |  i    e    o  |   ar = ar
     ' = rh     |   in   te   or|  are = are
    ph = pt     |  n    t    r  |   at = at
                |   an   th  TAB|
                |  a    h    s  |
|---------------|---------------|---------------|
|  •            |       •       |            •  |
|               |               |               |
|  1    2    3  |  c    d    u  |  ,  ENTER  .  |
|               |               |               |
|  4    5    6  |  f    l    w  |  ←    ↑    →  |
|   <    >      |   j    -    sh|   (    )      |
|  7    8    9  |  g    m    y  | ESC   ↓    "  |
|---------------|---------------|---------------|
|  •            |       •       |            •  |
|               |               |               |
|  •            |  •            |            •  |
|               |               |               |
| DEL  CPY  PST | co   it       |  !    ?    ;  |
|   F1   F2   F3|               |   F7   F8   F9|
| UDO  CUT  RDO | ck   ch       |  #    $    :  |
|---------------|---------------|---------------|
|  •            |       •       |            •  |
|               |               |               |
|       •       |       •       |       •       |
|               |               |               |
|  /    @    \  |  0   le   re  | HOM  PUP  END |
|   F4   F5   F6|               |   F10  F11 F12|
|  {    }    _  | de   ed   se  | INS  PDN      |
|---------------|---------------|---------------|
|  •            |       •       |            •  |
|               |               |               |
|            •  |            •  |  •            |
|               |               |               |
|  *    +    =  |  of   x   ro  |  `    &    ~  |
|               |        ex     |               |
|  [    ]    %  |       q    z  | CPS   |    ^  |
|---------------|---------------|---------------|
|               |               |               |
|               |               |               |
|  •            |       •       |            •  |
|               |               |               |
|      ti    ri | en        er  | on   to       |
|   ing         |   and  the    |               |   
|  k    v   is  |  p   he   es  | ion   b   st  |
|---------------|---------------|---------------|
4/15/2015: 37 MCCs